###############
#.............#
#.............#
#.............#
######..#######